R 1920 1080
NO ./textures/N.png    
SO ./textures/S.png
S
WE ./textures/W.png 
EA ./textures/E.png 
S ./textures/barrel.png
F 220,100,2 
C 225,123,40

1111111111111111111111111
1000000000000001100000001
101100000111000E002000001
1111111111110111111111111
          1001
          1011
     111111001
     100000011
     111111111

0123456789012345678901234567890