R 1920 1080
NO ./textures/N.png    
SO ./textures/S.png
WE ./textures/W.png 
EA ./textures/E.png 
S ./textures/barrel.png
F 220,100,2 
C 225,123,40

1111111111111111111111111
1000000000110000000000001
1011000001110000002000001
100100000000000000000000111111111
111111111011000001110000000000001
100000000011000001110111111111111
111101111111110100000010001
11110111111111011101010010001
11000000110101011100000010001
10002000000000001100000010001
10000000000000001101010010001
11000001110101011111011110N0111
11111111 1111111 111111111111 111111 111111111111